00006666
04000006
00000450
00002500
60013000
64400050
66600500
66660000