00006666
00000006
05400400
00012000
60003000
66400400
66600500
66660000