00006666
04000006
00200450
00000500
60513500
64400050
66600500
66660000