00006666
04000506
00005450
00002500
60013000
64400000
66600500
66660000