05006666
54500006
05000400
00002000
60013000
64400000
66600500
66660000