00006666
04000036
00200450
00000500
60010000
64400050
66600500
66660000