00006666
04000006
05000400
00012000
60003000
64400000
66600500
66660000