00000500
00505500
04400000
00012000
00003000
05004400
50000500
05000000