66666666
00000004
05100200
00044000
00044000
00000300
40000500
66666666