00060000
04060500
01060000
02000044
03000044
00060000
04060000
00060000