00066000
04060500
01060006
02000046
03000046
00060006
04060000
00066000