64000000
40000040
05060000
00012000
00603046
00600006
00000500
00440006