00550050
44020040
45000400
05005000
01000440
04400045
04400550
00003000