66000066
60005006
05400400
00012000
00003000
00400400
60500506
66000066