00006666
00000006
05400400
00012000
60003000
60400400
66000500
66600000