00046666
00000046
00200050
00010000
64003006
66000666
66550046
66660006