66666666
00000000
05100200
00044000
00044000
00000300
00000500
66666666