00000066
00505546
00000046
05012046
00603046
64600006
64000506
64000006