00000066
00505546
00000046
05012046
00003046
64000006
64000506
64000006