66000666
64000046
05000050
05012000
66666666
00030500
64000046
66005066